S.........
.T.T......
......#...
...#..#...
....#.....
...G......