S.........#.........
.WWWW.....#.........
.W..W.....#....#####
.W..W.....#....#...#
.W..WWWWWWW....#...#
.W.............#...#
.WWWWWWWWWWWWWW....#  
...............#...#
#####.TTTTT....#...#
#...#.T...T....#...#
#...#.T...T....#...G
#...#.TTTTT....#####
#...#..........#....
################....