S...#...
.T.W#..G
.T....##
..##....
.....WW.